0 -1 2 5 2 -1 -1 -1 3 5
1 1 2 4 5 2 1 3 -1 3
-1 2 -1 4 5 3 2 -1 4 4
2 3 -1 5 2 4 2 3 3 3
-1 2 3 3 6 3 3 2 3 3
2 -1 -1 3 4 1 2 2 3 4
5 2 2 1 2 1 1 1 1 -1
5 1 1 5 1 1 1 1 -1 1
5 3 2 1 -1 2 2 6 1 -1
4 3 2 2 -1 1 1 2 4 2